####################
#..................#
#..................#
#..................#
#..................#
#......######......#
#..................#
#..................#
#..................#
#....##########....#
#..................#
#..................#
#..................#
#..##############..#
#..................#
#..................#
#..................#
####################
