####################
#..................#
#..................#
#..................#
#..................#
#....##########....#
#..................#
#..................#
#..................#
#..####......####..#
#..................#
#..................#
#..................#
#....##########....#
#..................#
#..................#
#..................#
####################
