####################
#..................#
#..................#
#..................#
#..................#
#......######......#
#..................#
####............####
#..................#
#......######......#
#..................#
####............####
#..................#
#......######......#
#..................#
#..................#
#..................#
####################
