####################
#..................#
#..................#
#..................#
#..................#
###..............###
#.......##.........#
#..............##..#
#..##..............#
#..........##......#
#..................#
#....##..........###
###................#
#.........##.......#
#..............##..#
#....##............#
#..................#
####################
